1;2;3;4;5;6;7;8;9;10;11;12;13;14;15;16;17;18;19;20;21;22;23;24;25;26;27;28;29;30;31;32;33;34;35;36;37;38;39;40;41;42;43;44;45;46;47;48;49;50;51;52;53;54;55;56;57;58;59;60;61;62;63;64;65;66;67;68;69;70;71;72;73;74;75;76;77;78;79;80;81;82;83;84;85;86;87;88;89;90;91;92;93;94;95;96;97;98;99;100
0;0;0;0;0;0;0;0;0;0;0;0;0;0;0;0;0;0;0;0;0;0;0;0;0;0;0;0;0;128;128;128;128;128;128;128;128;128;128;128;128;128;128;128;128;128;128;128;128;128;128;128;128;128;128;128;128;128;128;128;128;128;128;128;128;128;128;128;128;128;128;128;0;0;0;0;0;0;0;0;0;0;0;0;0;0;0;0;0;0;0;0;0;0;0;0;0;0;0;0
0;0;0;0;0;0;0;0;0;0;0;0;0;0;0;0;0;0;0;0;0;0;0;0;0;0;0;0;0;128;128;128;128;128;128;128;128;128;128;128;128;128;128;128;128;128;128;128;128;128;128;128;128;128;128;128;128;128;128;128;128;128;128;128;128;128;128;128;128;128;128;128;0;0;0;0;0;0;0;0;0;0;0;0;0;0;0;0;0;0;0;0;0;0;0;0;0;0;0;0
0;0;0;0;0;0;0;0;0;0;0;0;0;0;0;0;0;0;0;0;0;0;0;0;0;0;0;0;0;128;128;128;128;128;128;128;128;128;128;128;128;128;128;128;128;128;128;128;128;128;128;128;128;128;801;801;801;801;801;801;801;801;801;801;801;801;801;801;801;801;801;801;0;0;0;0;0;0;0;0;0;0;0;0;0;0;0;0;0;0;0;0;0;0;0;0;0;0;0;0
0;0;0;0;0;0;0;0;0;0;0;0;0;0;0;0;0;0;0;0;0;0;0;0;0;0;0;0;0;128;128;128;128;128;128;128;128;128;128;128;128;835;837;835;839;837;837;835;839;801;801;801;801;487;;;;;;;;;;;;;;;;;;;800;0;0;0;0;0;0;0;0;0;0;0;0;0;0;0;0;0;0;0;0;0;0;0;0;0;0;0
0;0;0;0;0;0;0;0;0;0;0;0;0;0;0;0;0;0;0;0;0;0;0;0;0;0;0;0;0;128;128;829;830;831;832;128;128;128;128;128;825;834;836;834;838;836;836;834;838;277;276;277;277;276;;;;;;;;;;;;;;;;;;;800;;;0;0;0;0;0;0;0;0;0;0;0;0;0;0;0;0;0;0;0;0;0;0;0;0;0
0;0;0;0;0;0;0;0;0;0;0;0;0;0;0;0;0;0;0;0;0;0;0;0;0;0;0;0;0;128;128;828;0;0;0;833;128;128;128;829;0;0;0;0;0;0;0;0;450;278;279;279;279;278;;;;;;;;;;;;;;;;;;;800;0;0;0;0;0;0;0;0;0;0;0;0;0;0;0;0;0;0;0;0;0;0;0;0;0;0;0
0;0;0;0;0;0;0;0;0;0;0;0;0;0;0;0;0;0;0;0;0;0;0;0;0;0;0;0;0;128;827;826;0;0;0;0;830;831;832;828;0;0;0;0;0;441;451;452;474;781;781;781;781;780;;56;37;38;36;57;;;;;;;;;;;;;800;0;0;0;0;0;0;0;0;0;0;0;0;0;0;0;0;0;0;0;0;0;0;0;0;0;0;0
0;0;0;0;0;0;0;0;0;0;0;0;0;0;0;0;0;0;0;0;0;0;0;0;0;0;0;0;0;128;824;823;0;0;0;0;0;0;0;0;0;0;0;0;453;461;128;128;128;128;128;128;128;50;;61;63;64;68;60;;;;;;;;;;;;;800;;0;0;0;0;0;0;0;0;0;0;0;0;0;0;0;0;0;0;0;0;0;0;0;0;0;0
0;0;0;0;0;0;0;0;0;0;0;0;0;0;0;0;0;0;0;0;0;0;0;0;0;0;0;0;0;128;825;0;0;0;0;0;0;0;0;0;442;451;454;452;128;128;128;128;128;128;128;128;128;50;;;;;;;;;;;;;;;;;;;800;;0;0;0;0;0;0;0;0;0;0;0;0;0;0;0;0;0;0;0;0;0;0;0;0;0;0
0;0;0;0;0;0;0;0;0;0;0;0;0;0;0;0;0;0;0;0;0;0;0;0;0;0;0;0;0;824;823;0;0;0;0;0;0;0;451;452;462;128;128;128;128;128;128;128;128;128;128;128;128;50;;;;;;;;;;;;;;;;;;;800;;0;0;0;0;0;0;0;0;0;0;0;0;0;0;0;0;0;0;0;0;0;0;0;0;0;0
0;0;0;0;0;0;0;0;0;0;0;0;0;0;0;0;0;0;0;0;0;0;0;0;0;0;0;0;0;822;821;0;0;0;0;0;0;453;128;128;128;128;128;128;128;128;128;128;128;128;128;128;128;50;;;;;;;;;;;;56;37;38;36;118;;;802;801;801;0;0;0;0;0;0;0;0;0;0;0;0;0;0;0;0;0;0;0;0;0;0;0;0;0
0;0;0;0;0;0;0;0;0;0;0;0;0;0;0;0;0;0;0;0;0;0;0;0;0;0;0;0;0;128;820;444;445;446;447;451;452;128;128;128;128;128;128;128;128;128;128;128;128;128;128;128;128;50;;;;;;492;38;118;;;;61;63;64;68;138;119;;;0;0;0;0;0;0;0;0;0;0;0;0;0;0;0;0;0;0;0;0;0;0;0;0;0;0;0
0;0;0;0;0;0;0;0;0;0;0;0;0;0;0;0;0;0;0;0;0;0;0;0;0;0;0;0;0;128;128;464;465;466;467;128;128;128;128;128;128;128;128;128;128;128;128;128;128;128;128;128;128;50;;;;;;61;68;138;119;;;;;;;89;139;37;36;37;0;0;0;0;0;0;0;0;0;0;0;0;0;0;0;0;0;0;0;0;0;0;0;0;0;0
0;0;0;0;0;0;0;0;0;0;0;0;0;0;0;0;0;0;0;0;0;0;0;0;0;0;0;0;0;128;128;128;128;128;128;128;128;128;128;128;128;128;128;128;128;128;128;128;128;128;128;128;128;50;;;;;;;;89;138;119;;;;;;;90;63;40;1;2;0;0;0;0;0;0;0;0;0;0;0;0;0;0;0;0;0;0;0;0;0;0;0;0;0
0;0;0;0;0;0;0;0;0;0;0;0;0;0;0;0;0;0;0;0;0;0;0;0;0;0;0;0;0;128;128;128;128;128;128;128;128;128;128;128;128;128;128;128;128;128;128;128;128;128;128;128;128;50;36;37;38;534;;;;;89;138;119;;;;;;;;800;0;0;0;0;0;0;0;0;0;0;0;0;0;0;0;0;0;0;0;0;0;0;0;0;0;0;0
0;0;0;0;0;0;0;0;0;0;0;0;0;0;0;0;0;0;0;0;0;0;0;0;0;0;0;0;0;128;128;128;128;128;128;128;128;128;128;128;128;128;128;128;128;128;128;128;128;128;128;128;128;128;3;2;3;45;;;;;;89;139;37;534;;;;;;800;0;0;0;0;0;0;0;0;0;0;0;0;0;0;0;0;0;0;0;0;0;0;0;0;0;0;0
0;0;0;0;0;0;0;0;0;0;0;0;0;0;0;0;0;0;0;0;0;0;0;0;0;0;0;0;0;128;128;128;128;128;128;128;128;128;128;128;128;128;128;128;128;128;128;128;128;128;128;128;128;128;128;128;128;50;;;;;;;90;63;60;;;75;76;37;800;0;0;0;0;0;0;0;0;0;0;0;0;0;0;0;0;0;0;0;0;0;0;0;0;0;0;0
0;0;0;0;0;0;0;0;0;0;0;0;0;0;0;0;0;0;0;0;0;0;0;0;0;0;0;0;0;0;0;0;0;0;0;0;0;0;0;0;0;0;0;0;128;128;128;128;128;128;128;128;128;128;128;128;128;50;;;;;;;;;;;492;95;96;1;128;0;0;0;0;0;0;0;0;0;0;0;0;0;0;0;0;0;0;0;0;0;0;0;0;0;0;0
0;0;0;0;0;0;0;0;0;0;0;0;0;0;0;0;0;0;0;0;0;0;0;0;0;0;0;0;0;0;0;0;0;0;0;0;0;0;0;0;0;0;0;0;128;128;128;128;128;128;128;128;128;128;128;128;128;50;;;;;;;;;;;40;41;42;128;128;0;0;0;0;0;0;0;0;0;0;0;0;0;0;0;0;0;0;0;0;0;0;0;0;0;0;0
0;0;0;0;0;0;0;0;0;0;0;0;0;0;0;0;0;0;0;0;0;0;0;0;0;0;0;0;0;0;0;0;0;0;0;0;0;0;0;0;0;0;0;0;128;128;128;128;128;128;128;128;128;128;128;128;128;50;;;;;;;;;;;800;128;128;128;128;0;0;0;0;0;0;0;0;0;0;0;0;0;0;0;0;0;0;0;0;0;0;0;0;0;0;0
0;0;0;0;0;0;0;0;0;0;0;0;0;0;0;0;0;0;0;0;0;0;0;0;0;0;0;0;0;0;0;0;0;0;0;0;0;0;0;0;0;0;0;0;128;128;128;128;128;128;128;128;128;128;801;801;801;487;;;;;;;;;;;802;801;801;801;128;0;0;0;0;0;0;0;0;0;0;0;0;0;0;0;0;0;0;0;0;0;0;0;0;0;0;0
0;0;0;0;0;0;0;0;0;107;81;128;128;128;128;128;128;128;128;128;128;128;128;128;128;128;128;128;128;128;128;128;128;128;128;128;128;128;128;128;128;128;128;128;128;128;128;128;128;128;128;128;128;50;;;;;;;;;;;;;;;;;;;800;0;0;0;0;0;0;0;0;0;0;0;0;0;0;0;0;0;0;0;0;0;0;0;0;0;0;0
0;0;0;0;0;0;0;0;106;128;128;128;128;128;128;128;128;128;128;128;128;128;128;128;128;128;128;128;128;128;105;128;128;796;105;128;128;128;128;128;128;128;128;128;128;128;128;128;128;128;128;128;128;50;;;;;;;;;;;;;;;;;;;800;0;0;0;0;0;0;0;0;0;0;0;0;0;0;0;0;0;0;0;0;0;0;0;0;0;0;0
0;0;0;0;0;0;107;108;128;128;128;128;128;128;128;128;128;128;128;128;128;128;128;128;128;356,799;359,798;399,806;398,807;418,798;796;419,806;359,807;397,797;355,798;796;128;105;128;128;128;128;128;128;128;128;128;128;128;128;128;128;128;50;;;;;;;;;;;;;;;;;;;800;0;0;0;0;0;0;0;0;0;0;0;0;0;0;0;0;0;0;0;0;0;0;0;0;0;0;0
0;0;0;0;0;102,129;130;128;128;128;128;128;128;128;128;128;128;128;128;128;128;128;128;398,806;419,807;399;358;359;395;396;355,797;399;357;417;418;399,797;355,798;796;128;128;128;128;128;128;128;128;128;128;128;128;128;128;128;50;;;;;;;;;;;;;;;;;;;800;0;0;0;0;0;0;0;0;0;0;0;0;0;0;0;0;0;0;0;0;0;0;0;0;0;0;0
0;107;83;82;108;123;128;128;128;128;128;128;128;128;128;128;128;128;128;128;128;105;808;359,809;358;419;357;419;415;416;355;418;355;358;419;418;356;797;798;806;794;793;807;804;128;796;105;128;128;128;128;128;128;50;;;;;;71;72;73;;;71;72;73;;;;;;800;0;0;0;0;0;0;0;0;0;0;0;0;0;0;0;0;0;0;0;0;0;0;0;0;0;0;0
0;804;128;128;128;128;128;128;128;128;128;128;128;128;128;128;128;128;128;128;128;399,806;359,807;359;419;418;397;418;358;357;398;357;359;358;398;399;357;0;0;0;0;0;0;803;799;797,812;813;128;105;128;128;128;128;50;;;;;;91;92;93;;;91;92;93;;;;;;800;0;0;0;0;0;0;0;0;0;0;0;0;0;0;0;0;0;0;0;0;0;0;0;0;0;0;0
0;805,803;128;801;801;801;801;801;801;801;801;801;801;801;801;801;801;801;801;128;808;358,81,809;356,811;356;398;358;417;359;419;356;419;358;359,107;355,81;359,811;359;358;0;0;0;144;145;;0;0;814;815;816;794;789;801;801;801;487;;;;;;111;112;113;;;111;112;113;;;;;;802;0;0;0;0;0;0;0;0;0;0;0;0;0;0;0;0;0;0;0;0;0;0;0;0;0;0;0
0;107,805;50;202,27;202;202;202;202;202;202;202;202;202;202;202;202;202;202;202,273;800;128;128;808;418,809;419;355;418;355;398;399;399;359;419,804;128;128;419,795;419,81;356,811;359;0;164;165;166;0;0;817;818;819;0;0;156;746;134;115;;;;;;131;132;133;;;131;132;133;;;;;;0;0;0;0;0;0;0;0;0;0;0;0;0;0;0;0;0;0;0;0;0;0;0;0;0;0;0;0
805;128;50;221;223;224;224;225;226,34;227;228;228;229;226,341;223;224;224;225;226;800;128;128;359,799;397;418;419;356;357;355;356;358;419;398,803;128;128;128;128;808;419,809;183;184;185;186;187;188;189;783;5;11;12;154,4;134,5;135,8;134,785;;;;;;151;152;153;;;151;152;153;;;;;;0;0;0;0;0;0;0;0;0;0;0;0;0;0;0;0;0;0;0;0;0;0;0;0;0;0;0;0
0;804;50;261;283;284;284;285;266;307;308;308;309;266;283;284;284;285;266;800;128;808;399,809;417;358;359;398;399;399;355;418;419;358;357,804;128;128;128;128;128;203;204;205;206;207;208;209;790;791;33;34;2;1;3;2;3;23;24;25;0;171;172;173;;;171;172;173;;;20;21;22;3;0;0;0;0;0;0;0;0;0;0;0;0;0;0;0;0;0;0;0;0;0;0;0;0;0;0;0
0;803;50;281;263;264;264;265;286;0;0;0;0;286;263;264;264;265;286;800;128;128;398,81;358,811;357;356;357;355;397;357;399;398;355;418,803;128;128;128;128;128;128;128;128;128;128;128;128;128;128;128;128;128;128;128;128;128;43;44;1;1;2;3;3;2;1;2;1;3;2;1;2;41;42;128;0;0;0;0;0;0;0;0;0;0;0;0;0;0;0;0;0;0;0;0;0;0;0;0;0;0;0
0;805;50;281;243;344;345;245;286;0;0;0;0;286;243;344;345;245;286;800;128;128;128;808;356,809;359;395;396;417;419;359;358;358,107;398,108;128;128;128;128;128;128;128;128;128;128;128;128;128;128;128;128;128;128;128;128;128;128;128;128;128;128;128;128;128;128;128;128;128;128;128;128;128;128;128;0;0;0;0;0;0;0;0;0;0;0;0;0;0;0;0;0;0;0;0;0;0;0;0;0;0;0
0;805,109;50;281;263,19;264;264;265;286;0;0;0;0;286;263;264;264;265,19;286;802;801;801;356,806;358,807;359;358;415;416;358;357;355;418,106;128;128;128;128;128;128;128;128;128;128;128;128;128;128;128;128;128;128;128;128;128;128;128;128;128;128;128;128;128;128;128;128;128;128;128;128;128;128;128;128;128;0;0;0;0;0;0;0;0;0;0;0;0;0;0;0;0;0;0;0;0;0;0;0;0;0;0;0
0;129,805;50;281;283,39;284;284;265,26;286,27;7;0;0;6;286,28;283,29;284;284;285,39;286;687;766;660;355;356;358;358;357;399;356;419,107;418,108;128;128;128;128;128;128;128;128;128;128;128;128;128;128;128;128;128;128;128;128;128;128;128;128;128;128;128;128;128;128;128;128;128;128;128;128;128;128;128;128;128;128;0;0;0;0;0;0;0;0;0;0;0;0;0;0;0;0;0;0;0;0;0;0;0;0;0;0;0
0;106;50;301,9;303,59,11;304,12;304,4;305,46;306,22;2;1;2;3;306,23;303,49;304,5;304,11;305,59,12;306,9;688,4;760,5;587,4;356,784;355;357;356,189;358,101;358,107;359,108;105;128;128;128;128;128;128;128;128;128;128;128;128;128;128;128;128;128;128;128;128;128;128;128;128;128;128;128;128;128;128;128;128;128;128;128;128;128;128;128;128;128;128;128;0;0;0;0;0;0;0;0;0;0;0;0;0;0;0;0;0;0;0;0;0;0;0;0;0;0;0
805,129;128;50;40;33;34;1;41;42;128;128;128;128;43;44;1;33;34;2;3;1;1;2;3;1;685;686;128;128;128;128;128;128;128;128;128;128;128;128;128;128;128;128;128;128;128;128;128;128;128;128;128;128;128;128;128;128;128;128;128;128;128;128;128;128;128;128;128;128;128;128;128;128;0;0;0;0;0;0;0;0;0;0;0;0;0;0;0;0;0;0;0;0;0;0;0;0;0;0;0
0;128;128;128;128;0;0;0;0;0;128;128;128;128;128;128;128;128;128;128;128;128;128;128;128;128;128;128;128;128;128;128;128;128;128;128;128;128;128;128;128;128;128;128;128;128;128;128;128;128;128;128;128;128;128;128;128;128;128;128;128;128;128;128;128;128;128;128;128;128;128;128;128;0;0;0;0;0;0;0;0;0;0;0;0;0;0;0;0;0;0;0;0;0;0;0;0;0;0;0
0;0;0;0;0;0;0;0;0;0;0;128;128;128;128;128;128;128;128;128;128;128;128;128;128;128;128;128;128;128;128;128;128;128;128;128;128;128;128;128;128;128;128;128;128;128;128;128;128;128;128;128;128;128;128;128;128;128;128;128;128;128;128;128;128;128;128;128;128;128;128;128;128;0;0;0;0;0;0;0;0;0;0;0;0;0;0;0;0;0;0;0;0;0;0;0;0;0;0;0
0;0;0;0;0;0;0;0;0;0;0;0;0;0;0;0;0;0;0;0;0;0;0;0;0;0;0;0;0;0;0;0;0;0;0;0;0;0;0;0;0;0;0;0;0;0;0;0;0;0;0;0;0;0;0;0;0;0;0;0;0;0;0;0;0;0;0;0;0;0;0;0;0;0;0;0;0;0;0;0;0;0;0;0;0;0;0;0;0;0;0;0;0;0;0;0;0;0;0;0